###############
#......#....#.#
s.####..#.#...#
#.#...#..#..#.#
#.###..#...##.#
#....#..##.#..#
##.#..#...#..##
#.#..#..#.#.#.e
#.#.#..##.#.#.#
#.#.#.##..#...#
#.#.##...#.####
#.#..#.#.#....#
#.##.#.#.###.##
#......#......#
###############
