################s############################
#.#......#...#...#.#.#........##...#...#....#
#...##.###.#...#......#.###.#....#...#.#.##.#
##.###......###.###.#.#.#....####..###..#...#
#..##.###.#.......#.#..#..###....##...#.#.###
#.#...#..#.#.#.#.#..##.#.#...#.#....#...#...#
#.##.#..#...#...#..#...#.#.#..#.#.#..#.#..#.#
#..#...#..#.#.#..#.#.##..#.##....#..#.##.#..#
##..#.#..##..#..#..#....#....#.#..#.#....#.##
###.#..#...#.#.##.##.#.#..###...#.#.#.####..#
###.##..##.#.#.#..#...#..#...##.#.#.#.#....##
##.....###.#..#..#..##..##.#.#.#..#.#.#.##..#
#..####.#..##.#.#..#...##..#...#.#..#.#...#.#
###.......#.#.#..##.#.#...#.##...#.#.#.##..##
#...#.####..#..#......#.##....####.#....##..#
#.##.#.....#.#..#.#.##..#..#.#.....#.##...#.#
#.#...#.##.#..#..##..#.#.#..#..####..#.##...#
#.#.#....#.##..#...#.#.#..#.#.#...#.##...##.#
#.#..###.#....#.##..#...#.#.#...#.#...#.##..#
#..#...#..###...#..#..##.....###..###.#....##
##..#.#..#..###.#.#..#...#.#...##...#..#.#..#
#.#.#..#.##.....#..#..#.#.####...##..#..#.#.#
#...##.#...#####.#..#.#....#...###.#..#...#.#
##.#...###.......#.#..#.##..###.....#.#.##..#
#...#.#...######....#.#.#.#.....#.#.#...#..##
#.##....#.#.....####..#.#..###.##..#.###.#..#
#.#..####...###......##..#....#..#.......##.#
#.#.#....###...####.#..#..###...#.#####.#...#
#.##.#.#.....#.....#..#.#...##.#........#.###
#.....#..#.##.#.##..#.#..##....#.#.#.###..#.#
#.#.#..#..#.....#..#...#...#.#..#..##....#..#
##.##.#.#.#.##.#..#..#..#.#.##.#..#...###..##
#.....#.#.#...#.##..#.#...#....#.##.###.#.#.#
#.####..#.#.#....#.#...#.#..####............#
#.#...#.#..#####...#.#.#...#....##.#.######.#
#..#.#...#..#...###..#..#.#..##...#.#.....#.#
#.##...#..#.##.#...#.#.###..#.#.#...#.###.#.#
#...##..#.#......#.##...#..#...#..##....#.###
#.#...#.#...###.#...#.#.#.#..#.###...##.#...#
#..##.###.##...#..#...#...#.##.....###...##.#
##..#....#.#.#.#######.###..#.###.#...##.##.#
#.#..###.#...#....#........#.....#..#...#...#
#.##.#.#.#.##.###.#.########.#.##..#.##.#.#.#
#......#........#.............#...#.......#.#
###############################e#############
