#######s######################
#..#.##............#.........#
#.#.....#.#.##.###...#####.#.#
#...#.#..#..#.#..####....##..#
#.####.###.#....#...#.##....##
#...#......#.##.#.#.#.#.####.#
####..##.##....#..#...#......#
#....#..#...##.##.####..##.#.#
#.#.#.#...#..#.........###..##
#.##...#.#.#..###.###.#.#.#..#
#....#..#...##...#...#.....#.#
#.#.###..#.#...#.#.#...##.##.#
#..#.###...#.##..#..#.##.#...#
##.#..#.##.#..#.###.#....#.#.#
#..##....#...#..##...#.#.#..##
#.#...##..###..#...#.#..#.#..#
#.#.##..#.#..#.####...#.#.##.#
#...#..##..#.#.....##.#....#.#
#.##.#...#.#.#####..##..##...#
##.....#...#.....##...#..#.###
#..####.#####.##..###..#..#..#
##.........#..#..#....###.#.##
#.########...#..#..#.#.#..#..#
#.#......#.#.####.#.##.#.#.#.#
#...##.##..##.....#....#.#...#
#.##.#..#.#.#.##.#.#.##...#.##
#.....#.....#.#.#....#..#....#
#.####.#####..#...#.#..#.##.##
##...........#..#.#...#......#
##e###########################
